WWWWWWWWWWWWWWW
W B B B B B BGW
WB B B B B B BW
W B B B BRB B W
WB B BYB B B BW
W B B   B B B W
WB B BPB B B BW
WBBBB   BBBBBBW
W B B B B B B W
W  B B B B B BW
W B B B B B B W
W  B B B B B BW
WWWWWWWWWWWWWWW